20              
9 0             
10 13           
35              
99              
2               
0               
3               
1 2 3           
25              
8               
0  0  0  0  0  0  0  0  0  0  0  0  0  0  0  0  0  0  0  0
1  1  1  1  1  1  1  1  1  1  1  1  1  1  1  1  1  1  1  1
0  0  0  0  0  0  0  0  1  0  0  0  0  0  0  0  0  0  0  1
0  1  1  1  1  1  1  1  1  0  1  1  1  1  1  1  1  1  1  1
0  1  0  0  1  0  0  0  0  0  1  0  0  0  0  0  0  0  0  1
1  1  1  0  1  0  1  1  1  0  1  1  1  1  1  1  1  1  0  1
1  0  1  0  1  0  0  0  1  0  1  0  0  0  0  0  0  1  0  1
1  0  1  0  1  1  1  1  1  0  1  0  0  0  0  1  0  1  0  1
0  0  1  0  0  0  0  0  0  0  1  1  1  1  0  1  0  1  0  1
1  1  1  1  1  1  1  1  1  0  0  0  0  1  0  1  0  1  0  1
0  0  0  1  0  0  0  0  1  1  1  0  0  1  0  1  0  1  0  1
0  1  0  1  1  1  1  0  0  0  1  0  1  0  0  1  0  1  0  1
0  1  0  1  0  0  0  0  1  0  1  0  1  1  1  1  0  1  0  1
0  1  0  1  0  1  1  1  1  1  1  1  1  0  1  0  0  1  0  1
0  1  0  1  0  0  0  0  1  0  1  0  1  0  1  0  0  1  0  1
0  1  0  1  1  1  1  0  1  0  1  0  1  0  1  0  0  1  0  1
0  1  0  1  0  0  0  0  1  0  0  0  1  0  1  0  0  1  0  1
0  1  0  1  1  1  1  1  1  1  1  1  1  0  1  0  0  1  0  1
0  1  0  0  0  0  0  0  0  1  0  0  0  0  1  0  0  0  0  1
0  1  1  1  1  1  1  1  1  1  0  1  1  1  1  1  1  1  1  1
