'Grassy Plains'
10              
0 2             
6 4           
35              
30              
5               
2               
1               
1           
9             
3               
1 1 1             
0   0   1   0   0   0   0   0   0   0
0   0   1   0   0   0   1   1   1   0
0   0   1   0   0   0   0   0   1   0
0   0   1   0   0   0   0   0   1   0
0   0   1   1   1   1   1   1   1   0
0   0   0   0   0   0   1   0   0   0
0   1   1   1   1   0   1   0   0   0
0   1   0   0   0   0   1   0   0   0
0   1   0   0   0   0   1   0   0   0
0   1   1   1   1   1   1   0   0   0               
